1 65 4847 4847 4847 4847 4847 4847 4847 4847 4847 4847 4847 4847 8210 8234 8246 4727 2161 8205 4192 4050 2487 5377 2284 1660 4593 8312 665 2829 8386 1475 4627 3619 8444 8478 2791 8517 3138 8530 4776 3138 8517 2791 8517 2791 8507 194 4056 8544 173 912 8532 8525 5450 232 4191 4004 8431 5029 2044 8402 2648 8407 8413 4150 3619 
1 34 5377 8241 514 3971 8249 8258 4517 8267 8275 4259 8279 8288 845 8318 5125 3385 8322 3251 8329 8342 1163 5013 8304 614 4767 8329 5021 1745 8408 1175 275 740 8382 5013 
1 9 8402 5162 8389 5484 4927 3836 1484 2737 1745 
1 9 8402 8390 4298 57 3988 8294 1556 1497 5377 
1 12 8530 539 279 8529 1727 277 2763 4179 1829 1623 3492 661 
1 3 3492 1759 8519 
1 8 8519 1717 8493 4813 3887 1585 5010 4410 
1 3 232 3608 3247 
1 5 3247 8426 3008 1476 1745 
1 2 5162 4837 
1 5 4837 8353 839 3270 4259 
1 17 3492 5098 8466 8428 8415 879 4265 5273 2627 1008 8323 8299 1327 2368 4652 3187 2284 
1 8 2627 8393 305 2028 3268 8485 5368 1727 
1 5 8466 8474 4672 8501 8485 
1 7 8485 3268 8447 8437 8433 2535 3619 
1 10 2487 4453 8196 8190 8156 8161 1109 94 8084 2792 
1 7 2792 448 699 7988 3629 4679 7982 
1 4 7982 3292 7992 4425 
1 2 4425 7991 
1 3 7992 4320 5446 
1 4 4679 562 4172 4133 
1 4 4133 7917 4869 4966 
1 11 8371 8364 2325 8396 5355 29 3453 2897 2794 8504 4760 
1 16 8371 2227 363 4964 8347 8331 4381 8317 8328 8333 4535 8320 8313 8306 2918 8299 
1 7 2227 1258 357 4059 1585 3907 1468 
1 10 8333 1619 5365 2540 3416 3591 8417 8424 8423 357 
1 6 5365 8388 8365 3036 8374 2627 
1 3 5365 8403 8415 
1 19 2553 8551 8560 873 2957 8565 2245 3248 1889 4665 4630 4391 712 3488 304 567 8385 8362 8368 
1 4 8592 553 2614 5530 
1 6 3441 6 3922 3047 458 5506 
1 26 8534 8540 1279 8542 8536 8537 8545 8522 4590 3616 1780 723 26 4391 8450 1070 3411 8434 4274 1223 3586 358 860 3453 3854 8465 
1 4 1858 5272 617 8612 
1 22 26 8443 462 3110 2639 3730 2090 8343 8319 8296 3257 8255 493 8235 8250 8242 2100 608 8276 8283 8303 2293 
1 20 2090 8387 1378 4600 2231 3488 1070 8459 8467 1227 595 1106 8549 2553 4760 3213 8538 3736 8546 3812 
1 7 2293 4560 4876 1111 4364 4638 2325 
1 2 8396 4788 
1 6 8225 8212 5325 8174 8147 679 
1 5 5325 8193 2471 5490 488 
1 4 488 8182 5102 3438 
1 7 3438 2060 4926 2920 8271 2237 1111 
1 2 8333 8311 
1 2 2918 4224 
1 3 4652 8244 469 
1 2 3187 3207 
1 2 3207 2487 
1 3 3207 4137 4408 
1 4 469 8204 8188 4408 
1 3 8188 5410 8185 
1 3 4137 3898 8178 
1 6 4224 8259 8230 8217 8202 8185 
1 4 8259 8248 5015 469 
1 4 2368 8273 4178 5015 
1 5 2627 8372 3160 1534 8386 
1 4 2368 8309 1656 8312 
1 4 8294 8278 952 514 
1 5 8259 8256 3241 4278 8269 
1 4 8269 5155 8254 650 
1 12 650 384 8221 8224 8214 1508 5304 564 352 3415 8183 3438 
1 6 384 4719 8284 4107 8330 8347 
1 4 5467 8095 5343 2792 
1 22 8110 494 5278 1245 8059 1991 8033 4817 2707 5255 3096 7954 1018 7934 7939 4455 153 8043 1301 1480 1867 7934 
1 6 3109 4289 749 4158 2625 1374 
1 3 1374 2073 4411 
1 4 4411 2306 4378 7887 
1 3 7887 7896 4133 
1 8 1506 10 3400 3180 1180 7376 2462 1560 
1 4 8156 4154 8102 8083 
1 3 8083 8049 7999 
1 3 3053 4992 8083 
1 7 7988 2600 1282 7990 3464 2216 7999 
1 8 7999 7969 7935 7882 1424 1130 7820 7786 
1 5 4289 4902 4166 5274 40 
1 4 40 4508 7618 7645 
1 4 7645 727 1739 7656 
1 4 1739 1009 591 1506 
1 7 7656 929 359 4328 7784 7811 7820 
1 10 7811 7786 5019 7741 2290 7674 2790 5500 4207 3796 
1 8 7882 7864 134 2106 7869 1753 1516 3211 
1 7 3211 7792 7758 2626 2928 480 2073 
1 2 3211 7760 
1 24 8062 3000 8016 3528 2127 7980 2300 7953 7948 7940 2805 7931 7910 5075 3330 7904 7886 7897 5023 7905 362 2152 7892 7882 
1 11 7904 1974 7957 4700 4544 250 8101 8112 4575 8167 8188 
1 6 8185 3203 8179 2608 8166 2947 
1 9 2947 1413 8128 5225 8070 8039 8007 287 7940 
1 4 5255 1931 283 2131 
1 5 2131 5059 1577 1390 7808 
1 8 7808 86 7717 1421 5195 7665 3283 4846 
1 28 4846 88 4088 35 5074 5079 3656 2751 330 4594 3328 2270 3507 7266 896 7255 3412 3719 7159 1806 7111 7087 1016 2946 7052 4592 2933 7171 
1 12 7052 1256 2765 3932 1935 7053 2267 7059 69 7086 7115 509 
1 6 1935 7109 623 4379 3561 335 
1 7 335 4479 4462 7295 183 7350 4594 
1 10 35 3280 3896 7463 2107 3466 4503 3621 41 7384 
1 6 3109 3973 5167 1981 126 4441 
1 7 2625 7623 1575 2581 663 7650 7616 
1 12 4441 7566 4591 663 471 1122 2797 4443 293 7862 7883 7887 
1 6 4172 1607 7865 4726 1155 2626 
1 3 1516 3309 7865 
1 7 7864 2499 7903 1832 1090 795 1282 
1 14 1560 1483 3622 3475 4023 7333 2030 7360 7387 4346 4844 7487 312 5274 
1 7 1596 247 3529 7430 1924 7437 3400 
1 8 247 5121 7519 1368 4791 3321 3454 7656 
1 5 5500 7573 100 7550 1368 
1 3 7641 4687 7674 
1 5 1368 7514 7486 7472 7437 
1 10 7904 7886 8739 7819 7790 2297 4840 7673 2103 3796 
1 9 8256 1737 2388 1651 8197 2145 2367 1057 8138 
1 6 8138 284 8098 4223 3085 3528 
1 5 8138 8152 8131 5225 8128 
1 4 1508 4782 2468 284 
1 9 679 8068 8047 8036 4552 4692 1838 4239 4210 
1 7 4210 7947 978 7976 3279 3220 8062 
1 8 7330 7358 1783 5451 3934 7526 3349 3796 
1 4 7303 3379 7338 5144 
1 6 5144 3979 1502 7419 4243 5283 
1 14 4243 2026 2465 2694 7546 7561 7565 7582 7593 3437 492 7592 1425 400 
1 15 4239 2750 204 3929 3983 1646 7752 7720 7694 5196 7675 3178 7647 7619 400 
1 9 7647 4402 7711 7724 4384 7789 1444 7833 3983 
1 7 400 1425 7629 7662 3794 7726 2141 
1 6 2141 4331 922 7630 1790 7582 
1 5 7630 2224 5186 7644 7629 
1 3 7629 7592 492 
1 6 3794 2542 7744 7769 7754 4384 
1 9 7769 3294 7832 7872 7878 5265 3010 2576 2127 
1 2 5265 2629 
1 2 2468 8135 
1 11 8178 8155 3891 3053 5344 8060 8037 8012 3033 3822 362 
1 2 3822 7949 
1 3 8101 8078 3606 
1 2 250 3450 
1 2 8039 1612 
1 2 3000 4809 
1 2 8254 8236 
1 7 7487 7496 7522 4703 5285 5447 10 
1 2 7522 140 
1 14 7630 5171 3671 418 968 3132 7791 7823 5435 519 7868 3968 1701 7910 
1 8 3557 968 843 1822 1512 408 1249 7535 
1 3 5283 3714 7535 
1 4 2694 4622 7563 408 
1 2 2465 7534 
1 6 7535 3442 7509 3399 2953 7526 
1 13 1512 5503 4435 7671 7692 7716 7745 2206 7747 7761 4810 3658 7790 
1 7 7745 2163 7827 7850 5107 7891 7910 
1 9 1512 7649 2146 7721 5289 3088 4380 7847 7868 
1 3 519 4322 7940 
1 4 3682 2549 7900 519 
1 2 2141 7748 
1 7 1360 3709 6989 7013 5310 2289 1418 
1 11 509 7100 2289 1549 3307 5326 7077 3120 4117 4231 7077 
1 8 7100 4288 192 7154 1027 3636 3998 716 
1 9 7401 7378 3868 2777 7292 7270 7242 7233 716 
1 6 7445 7427 7431 7422 7417 7401 
1 6 7445 5294 7474 3742 7552 7592 
1 7 7694 2909 7651 43 7603 4922 1574 
1 6 1574 2280 4746 7479 1532 7427 
1 8 2280 7528 1383 1588 7464 2431 7465 7448 
1 5 7448 5193 4106 2084 7401 
1 7 6800 5501 6781 6779 3004 4283 1077 
1 6 5501 4657 1287 6726 6699 3637 
1 12 5501 4438 6723 1066 6686 230 6645 3748 4713 6599 2504 6561 
1 10 2504 5012 2305 5414 2357 3702 3840 3174 6739 4919 
1 6 3174 6685 6694 2366 6709 2062 
1 7 6723 3476 6730 2062 6759 2111 4919 
1 6 6800 6799 6793 1578 3069 4919 
1 21 4013 2687 6859 6880 1478 6868 5415 482 6959 6987 1606 2223 2951 7088 4012 3316 4716 2810 7246 386 7298 
1 5 7298 7323 7363 5494 1596 
1 14 386 439 593 2417 787 4227 3889 7124 1208 1283 7193 7253 1114 2975 
1 9 7298 1157 2053 7254 5232 4790 7280 1017 7330 
1 4 1017 4031 3095 7253 
1 6 1017 7264 4669 4723 7146 7124 
1 10 7303 3897 7297 2975 7315 3210 1671 7348 5220 7330 
1 12 4227 4769 7032 6986 6956 6933 6921 3575 6893 847 6849 2657 
1 3 3575 4684 6859 
1 12 7253 5017 7177 3406 1005 2774 4550 7067 139 7082 2346 7124 
1 9 7338 7332 1610 1626 7267 219 3572 976 7303 
1 3 3897 7286 976 
1 9 7419 1304 5207 698 4083 7420 7443 7477 7509 
1 7 7876 3549 7874 3553 5228 2481 3983 
1 10 7876 1158 3139 2863 5197 823 7971 354 655 8047 
1 12 3549 370 1947 4022 2927 485 7680 4717 7622 5068 5081 1988 
1 3 4717 7632 1676 
1 4 2927 4818 3023 4184 
1 4 7876 4496 7842 7855 
1 3 1158 3340 4446 
1 6 2777 5140 1290 4772 7386 7401 
1 8 5294 3165 2630 3150 5035 2126 646 3927 
1 12 7386 2268 2039 2987 3927 2624 4229 3980 1540 7243 2451 7242 
1 4 1290 1344 7271 7243 
1 6 5068 7646 7689 2082 163 7635 
1 10 7384 4147 179 7385 2447 7390 3913 2914 7421 7448 
1 8 7385 7406 1841 4865 7512 1842 429 5068 
1 5 1842 7524 2467 413 7448 
1 7 43 7602 4212 111 1562 7490 7465 
1 5 7528 7482 7456 7426 7401 
1 17 3636 7175 1913 7145 7116 4299 4952 4574 7051 7035 7029 4170 7025 25 7042 5137 4117 
1 7 7025 3375 3100 7090 3827 7113 4231 
1 7 7077 4194 7099 7113 7133 7152 7175 
1 7 3913 2174 7318 443 200 1929 3636 
1 10 1929 1569 3323 7258 7284 2743 4851 946 5052 7384 
1 6 1569 7247 4461 3813 7356 7385 
1 5 7385 4690 895 4851 3701 
1 5 5144 4323 3532 4019 3150 
1 10 2465 7503 2128 7494 7502 7501 7469 7447 5374 4019 
1 3 7447 880 3165 
1 5 2694 3026 4957 332 5171 
1 3 150 5504 3415 
1 17 2774 555 1918 1912 4471 2568 3820 4621 789 2814 2651 3938 4490 6997 2070 4500 7035 
1 7 2451 7208 242 1505 4078 1501 7051 
1 14 1501 2168 2572 7142 1294 5267 2004 7227 613 7289 7307 7314 5404 1610 
1 4 2168 5168 1446 1294 
1 6 1446 3806 5432 7215 441 7267 
1 8 7267 7237 5473 5425 3976 7139 2426 3820 
1 6 5425 7178 81 1140 1473 7177 
1 3 7433 7453 3934 
1 6 1596 7450 4540 3382 236 3349 
1 2 3382 5500 
1 8 3575 1916 2658 4997 15 4292 2344 7067 
1 3 204 4205 1794 
1 4 400 4188 4304 4922 
1 2 2280 4188 
1 3 7647 7633 4922 
1 3 1425 1115 7647 
1 6 1425 4005 7557 7538 7529 2280 
1 4 7538 4681 7484 1532 
1 3 1115 7652 7662 
1 3 400 7575 7557 
1 4 1676 3229 1500 2909 
1 13 2230 1338 1980 4111 2020 6247 6248 4130 6231 1100 6223 5028 3457 
1 3 4393 2718 5028 
1 17 3457 6232 6204 2242 6196 6201 6210 3504 4367 6206 2389 706 3062 1456 3 6297 3162 
1 18 6297 6321 302 4699 6373 5236 6431 6451 1702 3357 1817 6539 1757 1318 4279 4006 2406 1614 
1 4 1318 6514 1342 1269 
1 14 984 6298 21 4617 4953 3797 4140 6375 4039 6361 3633 4429 6351 4699 
1 5 984 4937 902 6279 3 
1 2 706 984 
1 11 4006 6558 2828 3577 5391 2731 1430 2882 2815 5249 5475 
1 12 5475 2782 398 4521 3598 6742 6752 658 3995 5185 3814 4802 
1 2 3814 6742 
1 2 6558 5286 
1 6 623 1805 7129 1113 2676 509 
1 3 2676 7131 7115 
1 2 8595 8590 
1 4 2255 8591 4125 5419 
1 3 2826 576 3124 
1 3 2592 1696 8587 
1 39 4091 5082 8610 1858 8607 8605 1870 8600 2255 8596 8595 2226 2826 2378 8587 4134 5411 4582 4447 8593 2937 3441 3534 221 4732 4956 2347 8579 1335 4234 8566 3491 5259 8534 835 1315 8520 502 8533 
1 5 2347 8588 8589 8592 308 
1 4 8579 8571 5290 8563 
1 4 5024 8556 8548 8540 
1 2 8559 8545 
1 9 1315 4096 8472 4200 20 8416 234 44 8391 
1 11 5259 8540 5458 4213 2398 8471 1688 1260 8436 8438 3110 
1 2 3127 2398 
1 8 132 404 4705 8395 8412 474 2686 8436 
1 3 3841 4820 1889 
1 4 3616 8464 8448 8438 
1 3 8576 414 2245 
1 7 2293 8368 1496 4867 1886 4824 860 
1 6 4600 8380 8378 4044 2010 8385 
1 4 8362 12 8334 3325 
1 4 5143 8255 622 1583 
1 2 5356 8235 
1 3 3213 2760 2593 
1 9 8371 2419 5370 4410 8465 1468 3332 5219 8546 
