1 9 4410 5010 1585 3887 4813 8493 1717 8519 2308 
1 35 8216 2060 3438 8183 3415 352 564 8154 3666 4782 2468 2720 8209 8221 384 650 1608 2446 8330 4964 363 2227 8371 8364 2325 8396 5355 29 3453 3854 8473 2897 2794 8504 3213 
1 7 2227 1258 357 4059 1585 3907 1468 
1 19 2553 8551 8560 873 2957 8565 2245 3248 1889 4665 4630 4391 712 3488 304 3835 8385 8367 8362 
1 4 8592 553 2614 5530 
1 6 3441 6 3922 3047 458 5506 
1 26 8534 8540 1279 8542 8536 8537 8545 8522 4590 3616 1780 723 26 4391 8450 1070 3411 8434 4274 1223 3586 358 860 3453 3854 8465 
1 4 1858 5272 617 8612 
1 14 26 8443 462 3110 2639 3730 2090 8343 8319 8296 3257 8255 493 8235 
1 19 2090 8387 1378 4600 2231 3488 1070 8459 8467 1227 595 1106 8549 2553 4760 3213 8538 3736 4182 
1 11 5356 8235 8250 8242 2100 608 8276 8283 2811 2293 8368 
1 2 8396 4788 
1 54 7934 1867 1480 1301 819 4615 3704 7994 4455 7939 7934 1018 7954 2144 2707 4817 5519 1991 8059 1245 5278 8119 8110 8117 1778 4533 4737 5338 8189 5353 1129 8173 2097 8168 5087 424 4961 5270 8165 1431 1267 8130 8150 4089 8090 8064 4475 354 7971 823 5197 2863 3139 1158 
1 57 2707 5255 1931 556 7858 7798 7773 86 7717 4501 7624 3313 7551 820 5079 3656 7438 2751 330 4594 4046 3328 2270 7296 3507 4258 7266 896 3412 7223 2279 1806 7111 7087 1016 2946 7052 1256 2765 3932 1935 7053 2267 7059 69 7086 7115 7131 509 4602 7100 2289 5310 7013 6989 3709 1360 
1 31 1684 7439 4346 116 1314 2030 3699 1906 7336 3622 1483 1560 2462 7376 1925 2840 7437 7483 7539 4678 2804 3454 7656 1739 734 7618 558 40 5274 4166 4902 
1 2 8595 8590 
1 4 2255 8591 4125 5419 
1 3 2826 576 3124 
1 3 2592 1696 8587 
1 39 4091 5082 8610 1858 8607 8605 1870 8600 2255 8596 8595 2226 2826 2378 8587 4134 5411 4582 4447 8593 2937 3441 3534 221 4732 4956 2347 8579 1335 4234 8566 3491 5259 8534 835 1315 8520 502 8533 
1 5 2347 8588 8589 8592 308 
1 4 8579 8571 5290 8563 
1 4 5024 8556 8548 8540 
1 2 8559 8545 
1 9 1315 4096 8472 4200 20 8416 234 44 8391 
1 11 5259 8540 5458 4213 2398 8471 1688 1260 8436 8438 3110 
1 2 3127 2398 
1 8 132 404 4705 8395 8412 474 2686 8436 
1 3 3841 4820 1889 
1 4 3616 8464 8448 8438 
1 3 8576 414 2245 
1 10 3325 8334 12 8362 8368 1496 4867 1886 4824 860 
1 5 3835 5479 8378 8380 4600 
1 4 5143 8255 622 1583 
1 3 3213 2760 2593 
1 9 8371 2419 5370 4410 8465 1468 2509 8535 3736 
1 2 2817 2097 
1 5 4881 2006 2079 7058 16 
1 4 5091 143 7024 2006 
1 14 330 809 2673 1354 7329 3888 7311 3081 335 3561 4379 623 7109 1935 
1 8 3081 5342 3701 7274 3076 7213 7195 509 
1 26 2707 2439 7963 1220 1210 1628 291 2397 3070 7825 5516 5038 7736 7703 7668 1977 5375 3183 7536 1989 3931 7463 3896 3280 35 820 
1 2 5280 1220 
1 11 7536 3155 7544 5439 498 4363 4147 4152 895 2743 7274 
1 2 7111 5123 
1 21 5038 2312 3502 7718 7704 3107 7689 7646 5068 429 2172 4835 7459 1841 7390 3484 1244 3329 7232 1929 3636 
1 29 5081 5068 7622 7680 2187 4818 3668 7799 4639 353 7876 4496 7842 7855 5127 3144 1713 7911 579 2585 3420 4183 7985 7970 8001 4127 5280 8024 1245 
1 14 3329 4461 295 895 4690 7385 7406 1841 413 4712 2467 7524 1842 429 
1 8 1418 2289 1549 3307 5326 7077 3120 7004 
1 10 623 1805 7129 1113 2676 434 7195 7182 5341 4602 
1 2 7463 2107 
1 2 5079 5074 
1 2 3896 4341 
1 2 7544 7572 
1 6 7459 763 5145 179 4147 41 
1 5 498 7508 4208 763 7459 
1 3 7213 159 7182 
1 9 1841 7418 3913 2174 7318 443 4811 5305 3636 
1 8 7100 7112 7127 7132 369 1027 7175 3636 
1 2 7100 1549 
1 14 7632 4717 7680 2682 4038 3229 3875 5507 7564 3298 4712 7448 3640 7418 
1 2 1834 3668 
1 2 8189 2976 
1 2 3573 8119 
1 4 3144 2890 2709 5516 
1 16 1713 7946 3690 5252 8034 2445 5037 2265 5440 8173 8159 2477 8105 4360 8114 4533 
1 3 1778 3259 4183 
1 24 4533 802 4335 5281 1131 2935 1919 8115 2265 2844 477 3609 105 8165 2137 8092 4924 55 5337 459 4446 3340 1158 7876 
1 9 55 4214 8031 8046 231 8056 8126 477 8168 
1 6 8092 8097 8076 1309 8053 5453 
1 15 8147 771 5223 2069 8151 488 1663 8203 8216 5491 601 8253 220 8290 2293 
1 11 2100 8228 5154 829 8174 8147 8125 437 8068 8047 4475 
1 3 8228 8219 8218 
1 2 5448 8253 
1 13 2811 220 8286 2237 632 8282 1317 1681 211 2900 8284 8735 1608 
1 2 1663 8182 
1 2 1317 8264 
1 3 8582 1636 4001 
1 2 3067 181 
1 2 8209 2169 
1 2 564 8141 
1 10 4334 8304 614 4767 2752 8329 5021 8342 1163 5013 
1 2 1163 8304 
1 13 5021 913 8379 740 275 1175 3787 1237 3008 5105 1484 2737 4834 
1 15 5021 4834 2276 8322 3385 8302 8295 845 8288 8279 3270 839 8353 4837 5162 
1 3 5105 3836 8375 
1 2 8302 3770 
1 26 5105 344 4927 5484 8389 5162 2303 8390 8394 3175 2296 2328 8386 1534 3160 8372 2627 5273 4265 2643 2003 2700 8455 8466 5098 1623 
1 10 5165 8365 8348 8333 8311 8297 3014 545 8254 650 
1 12 4059 8445 5004 8424 8417 3591 3416 8398 5365 8388 5165 4265 
1 19 3014 4278 3241 2350 8289 5242 8259 8248 4178 8244 4652 3187 2284 5377 8241 514 3971 8249 8258 
1 12 4964 8347 8352 3289 1619 1072 8365 8359 915 549 3489 2918 
1 19 915 8374 5273 305 2028 8447 4271 2982 279 8529 1727 277 3445 4179 1829 1623 3492 1759 8519 
1 4 8466 8474 4672 8501 
1 14 2648 8418 1573 4150 3619 2535 8433 8437 8447 3268 8485 8501 1960 1727 
1 26 279 539 8530 3138 8517 8507 194 4056 8531 912 8532 8525 8514 361 4743 1453 4448 2648 8390 4298 57 3988 8294 1556 1497 5377 
1 9 8418 8430 4011 2983 4332 2791 8517 5441 1332 
1 3 173 8531 8513 
1 8 3008 4008 875 2214 3608 232 5450 8525 
1 11 4776 8530 8512 1212 4449 8449 8433 5254 3055 1475 8386 
1 21 8447 1966 8411 1126 3160 402 8341 8326 8309 2250 4652 2368 1327 8299 2918 5242 8265 8256 1737 2388 1651 
1 8 392 1596 247 5121 7519 1368 4791 4678 
1 12 2290 7676 7641 7613 5040 7550 7519 1836 5465 7430 2475 4662 
1 25 4441 126 1981 5167 7521 7515 4289 4902 7520 1684 7491 7487 7496 1330 5285 2761 4606 3180 2840 4286 1933 2475 7380 3372 5494 
1 23 7437 1924 7468 5465 5121 3473 7523 3382 236 3796 2690 7617 7640 4369 1463 2206 7745 3634 7768 3088 7777 7802 2532 
1 10 4441 7566 4591 3208 1071 7623 2625 4158 749 4289 
1 17 7566 7594 7616 4591 663 471 3915 7753 4443 293 7862 7883 7887 672 4718 537 3960 
1 2 558 140 
1 22 2625 1374 480 3960 2626 7758 1132 7760 3720 7738 2735 7759 5480 7812 5176 7811 7820 7786 5213 7708 3970 3454 
1 2 480 2073 
1 2 4443 1216 
1 3 7753 2797 3219 
1 2 3805 7708 
1 5 7786 5019 7741 2290 7722 
1 23 672 7896 7917 3123 3506 7961 7982 4981 5172 8042 3691 5343 2792 907 94 1109 8161 8192 8205 4192 4050 2487 8191 
1 5 7991 4425 7992 3292 7982 
1 2 3292 4452 
1 3 3506 2981 4966 
1 3 7917 4133 1707 
1 10 7760 3211 3308 3309 3358 7901 2286 4431 3629 5172 
1 10 4431 886 1171 4762 2917 2106 134 288 7841 7820 
1 5 3358 7859 1753 7869 2917 
1 13 8042 699 8013 1282 7990 3464 2216 7969 14 7922 2499 7864 7841 
1 9 8205 2161 4727 8246 8234 8210 4847 3200 8211 
1 7 8279 4259 8275 993 8300 2482 8294 
1 3 57 8314 8300 
1 3 8309 1656 4642 
1 19 3139 2958 1944 4293 5228 7839 2307 1646 7833 3803 7866 2110 1601 1750 7962 2820 697 3528 3085 
1 4 7976 273 1750 4941 
1 15 8047 8036 8015 1838 4239 2750 204 3929 3983 1646 4725 750 2450 7724 7711 
1 18 4293 992 4549 2750 3071 4205 7866 1174 7834 2135 7754 7711 4402 1115 7652 7662 3794 2322 
1 6 750 7737 7720 7701 7719 3229 
1 23 8057 3085 3589 8017 8004 7996 7981 287 2805 7944 4738 5075 3330 1176 3151 8739 4216 7853 3705 7877 533 1424 7841 
1 19 2468 8135 3121 4223 3085 2127 2576 213 4071 985 4796 7804 7776 7748 2141 4331 1835 5171 332 
1 11 2250 8266 1660 5057 1556 8278 4454 8258 4517 8267 8275 
1 2 8266 2284 
1 32 3207 8237 4652 3994 8204 5410 2410 5357 8109 8086 3045 8020 7997 7973 7960 7944 7931 1701 3968 7868 7847 3377 7802 534 7791 3132 968 418 3671 332 1790 7593 
1 15 213 7916 4307 7953 864 7996 8007 3002 8070 5225 3864 8093 1085 284 8135 
1 6 8070 1538 1612 8035 80 8020 
1 9 5225 2205 8153 4361 1651 2721 8269 5155 8254 
1 2 3388 5155 
1 12 1651 8187 4603 3197 3731 8217 223 8204 4909 4137 3207 2284 
1 2 8256 8259 
1 6 4361 8166 2608 8179 3203 3731 
1 13 7973 1229 7977 4700 7972 4157 8027 3606 3003 8112 4575 8167 5410 
1 5 1176 7904 1974 7957 4700 
1 9 7969 7999 8049 2241 5344 3053 3891 8155 8178 
1 7 4050 4453 8186 8164 8142 4154 5361 
1 5 5344 8060 8045 4181 461 
1 4 8060 1999 8075 3606 
1 16 4137 3898 4641 8139 1320 8094 8075 8041 8012 3033 3822 362 7905 5022 588 8739 
1 2 3003 8094 
1 9 4453 8191 8178 4641 2497 8167 4408 4137 2487 
1 10 5627 1529 3958 5653 3596 5681 96 2294 5108 2759 
1 72 3743 2498 4839 5597 5595 2827 2132 3426 5605 3116 191 5614 5620 945 5619 4855 5632 5640 4950 3189 5672 2520 5184 5665 1535 497 5652 2830 3153 1768 2355 5642 2430 3958 4656 506 5654 364 2759 5668 2955 2978 3360 5702 3152 4160 2770 5044 3579 2095 4109 2358 4576 5766 3094 428 495 5791 396 5803 640 3022 4660 2649 5837 3570 2803 5843 5842 2717 3384 3512 
1 10 3579 3079 2093 3099 5335 4098 2320 2076 2154 2149 
1 3 4098 4407 5676 
1 6 4160 5371 2234 4682 2411 5647 
1 5 5668 1971 1536 5646 503 
1 2 2833 5646 
1 2 161 5642 
1 25 4284 1768 5661 1148 5120 5699 5711 1580 906 187 4819 5768 464 5170 1385 3272 5194 5064 2083 5471 4634 3512 4668 788 3380 
1 10 4109 5749 5756 5755 3605 4898 5752 1613 5754 529 
1 7 5044 5732 5739 5317 5742 5730 5726 
1 17 4660 5835 5397 2798 2208 5857 5863 5862 2899 4394 5153 141 3380 3314 4051 5883 942 
1 4 4394 1899 2717 1624 
1 2 3862 2798 
1 5 2719 640 5814 5802 4683 
1 2 885 3570 
1 13 362 3705 1067 1243 2961 7722 2297 781 89 7707 7702 1463 7692 
1 2 134 2499 
1 5 362 2152 7892 7882 7864 
1 19 3151 8740 1664 8742 4569 1930 7745 7716 7692 2134 7615 935 7596 408 7563 4622 3026 4957 332 
1 17 3088 5289 7721 2146 7649 1512 408 2278 3714 5283 5243 878 1304 7403 7366 7338 3379 
1 9 1601 2862 7832 5358 2531 2322 7726 4907 4331 
1 2 1701 7891 
1 6 236 4207 4884 130 4840 7722 
1 2 4884 3991 
1 5 7550 100 7573 5500 4207 
1 34 236 7513 4670 7466 2823 392 5494 7363 7323 7298 386 7246 2810 4716 3316 4012 7088 2951 2223 1606 4781 3503 5415 6868 1478 6880 6900 6921 1916 6963 1252 7031 7047 7067 
1 25 386 439 593 2417 787 4227 4769 7032 6986 6956 6933 6921 3575 6893 847 6849 2657 6856 6864 1328 6825 3638 6842 6834 6824 
1 4 1478 6841 368 2687 
1 21 236 406 7495 3934 5451 7432 1137 217 7348 1671 3210 7315 4337 7322 4874 7303 976 3019 7231 7238 2005 
1 2 2781 4716 
1 2 7167 593 
1 14 3379 7303 3897 7297 7279 7263 7235 5017 7193 1283 1208 7124 3889 4227 
1 30 7348 5220 1695 3095 7253 5017 7179 3356 7110 4550 2774 3318 7006 3082 4277 4268 1798 6864 1522 6809 3069 1578 6793 6799 6800 5501 6781 6779 6787 1077 
1 9 7298 7305 4526 1700 3012 2452 5266 7330 5220 
1 6 7330 1017 7264 4669 4723 1208 
1 5 2823 7436 7433 7453 3934 
1 10 3714 4235 4619 5314 7477 7485 986 2953 7576 2690 
1 5 4550 7067 7082 2346 7124 
1 8 4277 4118 6970 466 6974 7001 2344 7067 
1 3 7031 3303 2346 
1 10 5501 4438 6723 1066 3670 3748 4713 6599 2504 6561 
1 9 6723 1738 6730 2062 6736 5347 4063 4919 3069 
1 11 2504 2824 3571 4104 5414 2357 255 6664 4557 230 3670 
1 14 2357 811 6594 4177 4680 177 3049 6478 6458 3676 499 6455 6426 3540 
1 2 6478 67 
1 29 4919 6785 2035 6776 6771 486 1331 4887 4611 1533 6638 5246 5282 6577 6598 6615 6635 6647 6670 786 6713 6732 6747 6770 1461 4886 6824 1396 1281 
1 5 1533 5072 6635 4007 6632 
1 6 2357 3702 2548 4302 6668 4887 
1 67 2230 1338 6265 1980 4111 2020 5092 5443 4130 6231 1100 6223 1042 5028 1002 6204 2242 6196 6201 6210 3504 4367 6206 4110 3062 1456 6278 6297 6321 302 4699 6373 5236 6431 6451 1702 3357 6539 1757 1318 2387 2406 1614 6605 3680 4006 6558 2828 3577 5391 2731 1430 2882 2815 5249 5475 3347 6720 4521 3598 6742 3814 5185 3995 658 6752 6742 
1 2 1042 3383 
1 2 3162 6278 
1 3 1318 6514 1342 
1 3 5286 4279 4006 
1 24 6196 1789 1307 3848 3006 296 6108 677 5103 2476 955 6084 2448 6069 6047 6071 6075 5445 6083 6089 6097 446 6114 6119 
1 2 6097 6117 
1 2 2476 2684 
1 4 6064 6069 2374 6071 
1 11 755 6047 5133 6022 82 5983 3011 5967 3146 4432 4 
1 23 4367 2891 6180 937 6150 4512 1904 1356 4555 3469 2379 6060 507 2092 6032 6025 4482 5999 4282 5982 1599 1164 3059 
1 3 1789 1975 6150 
1 3 6180 1394 6206 
1 11 298 2970 5912 4795 5909 5904 5911 1511 5928 5934 5938 
1 6 1511 3707 5922 651 5090 4709 
1 13 5902 1184 5918 651 5925 1 3791 4587 5300 5930 936 3005 5947 
1 5 5875 4936 942 138 5904 
1 9 788 5877 3066 2414 3317 580 1397 5885 3380 
1 8 3317 4532 403 5897 5908 5924 1199 5300 
1 8 5903 5517 1958 641 5924 5931 936 5060 
1 7 2889 5950 949 5952 1774 2950 857 
1 9 5950 4295 5943 669 3403 5923 2661 4799 641 
1 8 942 5893 5466 1350 5312 3188 5902 3423 
1 2 4587 5920 
1 5 949 5960 3857 857 5983 
1 28 4033 1166 450 1632 2457 6038 3351 268 5992 2619 5997 4845 4058 2138 1278 2582 2416 5965 1369 4704 5964 4702 5970 2045 2449 3311 3993 5953 
1 2 4092 2582 
1 6 6068 257 6045 6033 1740 5997 
1 9 6053 1073 6026 6012 6001 5986 5980 4151 1369 
1 7 893 6058 691 6021 2570 5989 4151 
1 2 2416 5968 
1 8 6012 2577 483 6018 1708 6030 6039 507 
1 20 268 4863 887 6070 5367 2071 2852 154 1044 2771 3695 6162 1376 6191 2785 6218 6226 6241 2963 5084 
1 2 1044 6111 
1 10 6206 6182 3759 4595 3523 1340 1434 2058 4033 6068 
1 13 3523 6135 2887 1411 3184 2011 605 1377 6170 3168 6178 525 1376 
1 3 4033 1166 450 
1 11 6060 3899 2340 4415 6053 6050 3566 6062 6067 893 6068 
1 2 589 1166 
1 2 2343 893 
1 6 2950 5993 5984 4984 5996 1599 
1 4 5982 2440 1013 5952 
1 14 2440 5961 4821 3613 5948 5947 5060 5953 2636 3863 4985 4525 1334 5953 
1 7 2092 3975 3737 4985 4175 2545 2045 
1 7 5953 5959 2459 4578 5199 5985 5999 
1 4 3737 6007 6009 4482 
1 9 6007 5995 4326 5985 2235 5969 4821 1880 745 
1 5 3613 5963 2235 5975 2440 
1 3 6017 759 5993 
1 10 5199 5981 4548 3863 4525 4175 2730 6016 6030 1997 
1 7 3311 3576 5958 5970 3527 2681 5964 
1 6 6431 2243 2143 2068 6351 302 
1 16 6373 2068 2506 1367 2514 4039 6375 4140 3797 1451 6324 1096 5392 2668 3186 6321 
1 3 3062 902 1096 
1 8 902 4937 984 2486 3977 6240 1161 4674 
1 9 1161 6233 6221 3209 1323 1253 6251 3452 6229 
1 3 1323 6198 2011 
1 4 6182 2389 706 902 
1 13 3797 1345 1767 6412 2898 251 5147 1796 674 6506 1597 3906 1581 
1 7 1345 6403 2979 4093 674 6492 2675 
1 5 2731 5173 2675 6487 4645 
1 6 5147 6472 6450 3310 6417 5301 
1 7 2815 4568 6612 4806 6630 4480 6653 
1 3 6612 6588 2882 
1 2 4802 3814 
1 3 4521 398 6716 
1 20 4480 6646 1406 4506 6681 995 3909 4481 188 6738 6747 3517 52 388 6771 2992 2339 3638 6863 6910 
1 2 3209 954 
1 16 4277 1950 7005 4195 5508 7038 7036 552 6984 4120 201 380 1281 6832 4306 6838 
1 7 7038 1193 4471 1912 7096 5117 2774 
1 15 7038 7065 7078 4471 3769 7139 3976 5425 2005 7267 1626 1610 7332 7338 5144 
1 3 7231 4803 5425 
1 7 7332 7357 7369 7364 7351 919 7276 
1 10 7364 3150 2630 3165 4244 7527 4843 492 925 7644 
1 9 4907 7670 7644 7629 3315 1115 7647 7633 84 
1 3 7357 4323 1887 
1 2 4323 5144 
1 11 3150 4019 5374 7423 3610 7449 7462 2128 7525 2694 4622 
1 6 418 2560 843 2443 1822 1512 
1 5 2128 7503 2465 468 3714 
1 4 2278 7547 7534 2465 
1 10 7670 2224 7612 7593 7568 2562 1399 7505 2164 4244 
1 5 7644 5186 2224 7630 5171 
1 6 2694 7546 7561 7565 156 2562 
1 3 7593 3437 492 
1 20 6229 5084 5077 5046 487 1995 6315 3493 6342 4459 1153 91 6317 6299 4445 6277 4928 6255 6235 6218 
1 6 6299 6301 6307 1995 6326 3300 
1 22 2963 6268 6288 6301 1771 3300 1153 551 6377 6383 6406 4895 3832 3847 4747 6509 568 5282 1736 6544 6537 2667 
1 4 6255 6271 6268 5077 
1 21 6277 2266 6295 1901 2202 6350 5427 4761 355 6392 1785 1154 6433 1694 3832 6422 6413 1936 1554 6387 6417 
1 8 1554 4914 6382 6377 2272 4812 4761 1785 
1 6 2272 2371 6343 4036 4076 2266 
1 3 2202 5382 4812 
1 4 2429 6505 6488 3847 
1 10 4747 6473 1555 3461 6421 5330 6409 1277 3540 3535 
1 3 499 6470 6485 
1 4 6455 967 6465 1555 
1 3 6409 1965 6426 
1 2 2410 3203 
1 5 1406 6676 2588 794 1869 
1 2 6577 5246 
1 2 6638 6622 
1 5 811 1547 3338 2247 6638 
1 6 6736 2366 6694 6685 3174 4302 
1 12 7701 2909 7669 84 4922 4562 7528 7482 7456 7426 7401 7386 
1 11 4712 7490 1562 3908 7537 4562 2280 4188 7557 4005 1425 
1 9 4712 7465 2431 4106 2084 7401 7417 7422 1531 
1 10 4843 3742 4975 737 1532 7431 1531 7386 4772 1290 
1 8 4244 3742 5383 7557 7538 4681 7484 1532 
1 5 4188 7633 7619 1425 3315 
1 3 2280 7529 4681 
1 23 4521 6791 6805 6822 6840 1087 3402 3195 2055 6996 7018 3923 3267 7004 2615 6990 3238 6981 947 6958 436 6947 6936 
1 17 1869 2262 6749 1653 6768 6775 3228 6791 6808 6823 6850 6862 6916 6936 4495 6969 2615 
1 6 6840 5136 3017 465 13 2055 
1 6 3307 7101 2736 7099 4194 7077 
1 13 7099 7113 7133 7152 7175 3998 7221 7245 3816 2777 3868 7378 2084 
1 10 3868 7353 1290 1344 4487 2451 7208 2153 716 3998 
1 7 3238 7025 3375 3100 7090 3827 7113 
1 16 919 7285 598 5515 374 7196 732 969 4078 1501 5027 4500 2683 6983 4358 3238 
1 5 374 5222 1540 7271 1344 
1 11 7208 7217 7243 7271 4838 7312 2039 746 3902 7415 7431 
1 7 7217 7200 7170 969 1505 242 2153 
1 4 3827 7145 1913 716 
1 11 3998 1913 7169 3785 7137 7120 7095 4574 7051 7035 4500 
1 15 1626 7278 441 7215 5432 3806 7126 4516 7091 1987 7054 115 2070 4500 432 
1 11 1610 5404 7314 3936 441 5321 3043 694 1446 5168 7091 
1 7 1446 7091 1987 4079 7054 432 5027 
1 2 4079 5168 
1 7 678 6721 6750 1653 6783 6806 6794 
1 12 2262 1825 5474 3242 1565 6773 6777 2259 6807 1943 4538 6770 
1 14 2055 4930 5175 4486 6943 4495 6924 64 5459 6850 2848 5178 3065 1653 
1 8 3267 7003 6982 4486 6930 6909 6888 3017 
1 8 5178 3487 6896 436 1412 6869 3593 6806 
1 7 1565 6851 6878 5319 6944 4534 2683 
1 19 1412 6899 4280 4285 4103 6851 3119 6877 2949 6958 4534 3147 6948 6937 3206 2956 6891 1428 201 
1 5 3487 3593 4751 5284 3242 
1 2 995 3355 
1 7 5319 5449 3295 6879 2391 2479 6838 
1 11 5508 7026 808 831 201 6928 3564 6910 3444 6950 4277 
1 6 3564 624 6834 2757 5244 52 
1 7 3517 6792 4886 1396 4218 6904 6928 
1 3 6807 4097 6838 
1 3 4538 6798 6832 
1 49 7915 3912 7860 3060 2402 3264 4989 664 7679 4167 7589 1773 7549 7516 4018 7470 1868 7409 2692 1302 7339 705 7283 2162 939 7209 7180 851 2527 859 7079 7083 346 2352 7057 7064 1602 610 7049 1365 7014 6994 6968 6962 6946 6942 3587 4077 510 
1 8 2402 7805 4661 50 2369 1940 106 4768 
1 8 3264 1519 7763 898 3734 1192 1985 4868 
1 14 2692 7394 904 2124 2772 4584 637 2370 419 7585 2894 7581 3880 1255 
1 13 7581 7507 2349 3396 1705 4275 7277 4982 7202 768 7147 3826 7083 
1 12 1705 7373 675 2177 7343 965 7262 2407 7163 2972 7125 1602 
1 22 510 7012 1802 3480 542 184 7160 7204 7249 1824 7281 1047 4586 168 2027 1207 4123 2301 7444 7413 131 2177 
1 26 2692 4993 5234 7308 1584 7301 5315 7294 1714 4198 2865 7240 3269 7186 1932 1823 2218 3928 2699 6964 6939 3021 6860 4016 127 3468 
1 10 7589 7559 2698 449 289 7407 7393 4015 2612 7294 
1 10 2177 2213 5163 7511 2769 7587 1851 7604 7620 479 
1 21 2533 2642 6829 6860 6872 6875 6865 453 6907 3028 1791 3027 910 774 2537 6873 948 4934 1118 376 966 
1 7 774 19 6999 2662 7033 1202 7079 
1 13 5315 4958 4366 5520 1766 7173 1595 4913 4766 2016 7104 4764 859 
1 3 4766 996 1689 
1 23 774 6870 6836 4173 2203 4142 6692 1621 2879 2157 6604 4916 1732 1119 2712 3700 1640 6573 1998 6581 1731 326 4507 
1 17 7589 2101 3362 4536 4250 4773 905 7598 2345 7626 4697 8 2415 5390 7497 5033 2072 
1 19 5483 2483 6434 1401 6500 6507 145 6556 6564 711 6611 2335 2669 6640 3462 6684 2518 2578 966 
1 4 2662 5156 3215 6873 
1 20 1734 66 6173 2129 4765 170 6293 6311 3407 938 6362 2444 3414 1784 9 1863 3260 1359 6521 2701 
1 12 938 548 6346 1337 6365 4024 3185 1104 760 6388 6401 430 
1 13 966 6767 4853 6812 1657 5157 3143 3982 4515 5307 6927 2403 5309 
1 2 5307 6942 
1 5 5307 6882 6876 6883 3063 
1 18 2518 6672 6650 6639 4386 5138 3903 2701 3798 6479 6468 3533 6481 6482 1897 1241 4027 430 
1 16 2701 4910 4113 1797 6562 6576 3255 6565 6572 6587 2749 2117 3277 4740 4297 1878 
1 12 3143 5201 2974 6740 6715 3286 6669 3881 3497 6623 2856 4386 
1 2 3881 2117 
1 9 430 4027 3657 828 6503 6540 6552 1945 6572 
1 13 6540 4794 297 2787 680 6476 3173 239 1063 2171 3261 3031 6374 
1 13 430 4148 6381 1815 6367 4199 6354 4889 4706 3873 6344 5158 6374 
1 7 3873 4440 6339 2094 2515 5200 5158 
1 4 4706 6320 6296 4673 
1 12 4706 6338 6309 4368 1487 6289 5109 6281 6274 3620 3154 1382 
1 10 5109 2896 1558 6205 983 6157 3339 4721 3686 6121 
1 9 1734 881 3788 6138 5114 3327 1268 4421 6121 
1 8 4199 278 6399 6425 3337 6464 3378 6503 
1 4 3337 6424 6444 4027 
