1 65 4847 4847 4847 4847 4847 4847 4847 4847 4847 4847 4847 4847 8210 8234 8246 4727 2161 8205 4192 4050 2487 5377 2284 1660 4593 8312 665 2829 8386 1475 4627 3619 8444 8478 2791 8517 3138 8530 4776 3138 8517 2791 8517 2791 8507 194 4056 8544 173 912 8532 8525 5450 232 4191 4004 8431 5029 2044 8402 2648 8407 8413 4150 3619 
1 34 5377 8241 514 3971 8249 8258 4517 8267 8275 4259 8279 8288 845 8318 5125 3385 8322 3251 8329 8342 1163 5013 8304 614 4767 8329 5021 1745 8408 1175 275 740 8382 5013 
1 9 8402 5162 8389 5484 4927 3836 1484 2737 1745 
1 9 8402 8390 4298 57 3988 8294 1556 1497 5377 
1 12 8530 539 279 8529 1727 277 2763 4179 1829 1623 3492 661 
1 3 3492 1759 8519 
1 6 8519 1717 8493 4813 3887 1585 
1 5 3812 5219 3332 1468 1585 
1 3 1468 8465 3854 
1 3 232 3608 3247 
1 5 3247 8426 3008 1476 1745 
1 2 5162 4837 
1 5 4837 8353 839 3270 4259 
1 17 3492 5098 8466 8428 8415 879 4265 5273 2627 1008 8323 8299 1327 2368 4652 3187 2284 
1 8 2627 8393 305 2028 3268 8485 5368 1727 
1 5 8466 8474 4672 8501 8485 
1 7 8485 3268 8447 8437 8433 2535 3619 
1 10 2487 4453 8196 8190 8156 8161 1109 94 8084 2792 
1 7 2792 448 699 7988 3629 4679 7982 
1 4 7982 3292 7992 4425 
1 2 4425 7991 
1 3 7992 4320 5446 
1 4 4679 562 4172 4133 
1 4 4133 7917 4869 4966 
1 2 3854 3453 
1 7 3453 29 5355 8396 2325 8364 8371 
1 16 8371 2227 363 4964 8347 8331 4381 8317 8328 8333 4535 8320 8313 8306 2918 8299 
1 5 1585 4059 357 1258 2227 
1 3 357 8423 8424 
1 8 8424 8417 3591 3239 2540 5365 1619 8333 
1 6 5365 8388 8365 3036 8374 2627 
1 3 5365 8403 8415 
1 7 5219 8535 3736 8538 3213 4760 8526 
1 3 8526 8549 3945 
1 3 3945 2666 2245 
1 3 2245 414 8576 
1 5 2245 4987 1889 4665 285 
1 3 285 4820 3841 
1 4 285 3105 4630 4391 
1 5 4391 26 8463 1780 3616 
1 3 3616 4590 8522 
1 3 8522 8545 8559 
1 2 8545 8537 
1 5 8537 8536 5458 8540 5259 
1 4 5259 3491 8566 4234 
1 3 4234 1335 8579 
1 6 8579 2347 8588 8589 8592 308 
1 4 8592 553 2614 5530 
1 3 2347 4956 4732 
1 4 4732 975 3534 3441 
1 3 3441 2937 8593 
1 5 8593 4447 4582 5411 4134 
1 3 3441 6 3922 
1 2 3922 3047 
1 3 3047 458 5506 
1 4 8579 816 5290 8563 
1 3 8540 8534 835 
1 5 835 1315 8520 502 8533 
1 7 8520 4096 8472 4200 20 8416 234 
1 3 4134 793 1219 
1 4 4134 8587 2378 2826 
1 3 2826 576 3129 
1 3 2826 2226 8595 
1 2 8595 8596 
1 4 8596 2255 8600 1870 
1 4 1870 8605 8607 1858 
1 4 1858 8610 5082 4091 
1 3 2255 1079 5419 
1 4 1858 5272 617 8612 
1 4 5259 8548 8556 5024 
1 3 8540 8499 3127 
1 5 3127 3131 1688 1260 8436 
1 6 8436 2686 474 8412 8395 4705 
1 3 4705 404 132 
1 3 8436 8438 3110 
1 6 3110 4581 8387 2090 1188 8296 
1 4 2090 3051 1378 4600 
1 7 8526 3963 2287 1837 8454 2674 1658 
1 3 1658 8459 4391 
1 5 1658 1070 3488 2231 4600 
1 4 1658 3411 567 3904 
1 3 567 304 3488 
1 6 8296 3257 5143 5356 8218 8219 
1 3 3257 2376 870 
1 5 8219 8228 8225 8276 8283 
1 3 8283 8303 2293 
1 4 2293 8332 8362 3904 
1 8 2293 4560 4876 1111 4364 4638 2325 8364 
1 6 3453 860 358 4867 5071 3904 
1 4 2287 827 8461 3453 
1 2 8362 12 
1 4 12 8334 8346 4044 
1 2 8396 4788 
1 2 3239 8347 
1 2 3239 4964 
1 6 8225 8212 5325 8174 8147 679 
1 5 5325 8193 2471 5490 488 
1 4 488 8182 5102 3438 
1 7 3438 2060 4926 2920 8271 2237 1111 
1 2 8333 8311 
1 2 2918 4224 
1 3 4652 8244 469 
1 2 3187 3207 
1 2 3207 2487 
1 3 3207 4137 4408 
1 4 469 8204 8188 4408 
1 3 8188 5410 8185 
1 3 4137 3898 8178 
1 6 4224 8259 8230 8217 8202 8185 
1 4 8259 8248 5015 469 
1 4 2368 8273 4178 5015 
1 5 2627 8372 3160 1534 8386 
1 4 2368 8309 1656 8312 
1 4 8294 8278 952 514 
1 5 8259 8256 3241 4278 8269 
1 4 8269 5155 8254 650 
1 12 650 384 8221 8224 8214 1508 5304 564 352 3415 8183 3438 
1 6 384 4719 8284 4107 8330 8347 
